1FFFFFFFFFFFFWBBFFF
FFFFFFFFFFFFWBBFFFB
FFFFFFFFFFFWBBFFFBB
FFFFFFFFFFWBBFFFBBW
FFFFFFFFFWBBFFFBBWF
FFFFFFFFWBBFFFBBWFF
FFFFFFFWBBFFFBBWFFF
FFFFFFFBBFFFBBWFFFF
FFFFFWBBFFFBBFFFFFF
FFFFWBBFFFBBWFFFFFF
FFFWBBFFFBBWFFFFFFF
FFWBBFFFBBWFFFFFFFF
FWBBFFFBBWFFFFFFFF2
