FFFFFFFFFFFFFFFFFFF
FFFFFFFFFFFFFFFFFFF
FF1FFFFFFFFFFFFFFFF
FFFFFFWFWFFFFFFFFFF
FFFFFFWFWFFFFFFFFFF
FFFFFFWFWFFFF2FFFFF
FFFFBFFFFFBFFFFFFFF
FFFFFBFFFBFFFFFFFFF
FFFFFFBBBFFFFFFFFFF
FFFFFFFFFFFFFFFFFFF
FFFFFFFFFFFFFFFFFFF
FFFFFFFFFFFFFFFFFFF
FFFFFFFFFFFFFFFFFFF
