1FFFBFBBBBBFBBBFFFF
FWFWBWFWBWBWFWBWFWF
FBBBBBBBBBBFBBBBBBF
BWBWBWBWBWBWBWFWBWF
BBFFBFBBBBBBBFBBBBB
BWFWFWBWFWFWFWFWBWB
BBBBBBBFBFBFBBBBBBB
BWBWFWBWBWFWFWBWBWB
BBBFBBBBBBBBBBBBBBB
FWBWFWBWBWBWBWBWBWF
FFBBBFBBBBFFBBBBBFF
FWBWBWFWFWFWFWBWFWF
FFFFBBBBBBBFBBBFFF2
